111111111111111111111
1000000000100000100E1
100100011110000010001
111100000010C00010001
100000011110000010001
100000000000000000011
111111100000000010001
1000000000000000100P1
100000100000000000001
10C000100000000000001
100000100000000000001
111111111111111111111
