111111111111111111111
10C000000010000010CE1
1001000111100C0011001
111111000000000010001
10C0000000C00000000P1
111111111111111111111
110110111000011111111
110110111111011111111
110000111100111111111
111110111011111111111
111110111000011111111
111111111111111111111
