111111111111111111111
10C0000000100000100E1
1001000111100C0000001
111111000000000010001
10C0000000C00000100P1
111111111111111111111
110110111000011111111
110110111111011111111
110000111100111111111
111110111011111111111
111110111000011111111
111111111111111111111
