1111111111111111
10010000000000E1
10010000C0000001
1111000000000001
100000000P000001
1111111111111111
