1111111111111111
10010000100000E1
10010100C0001001
1111010010001001
100000010P000001
1111111111111111
