1111111111111111
10000000000000E1
10000000C0000001
1000000000000001
10P0000000000001
1111111111111111
