1111111111111111
10000000000100E1
10000000C0011111
1000000000000001
100000000P000001
1111111111111111
