1111111111
10000100E1
1000011101
10000000P1
10000000C1
1000000001
1000000001
1000000001
1111111111
1111111111
1111111111
